Unicode 与 ASCII 符号 - Unicode versus ASCII symbols
万国码 - Unicode
上下文以及上下文语境化器 - Contexts and contextualizers
下标 - Subscripts
元对象协议 - Meta-object protocol (MOP)
函数 - Functions
列表、序列和数组 - Lists, sequences, and arrays
包 - Packages
Raku 原生类型 - Raku native types
原生调用协议 / Native calling interface
变量 - Variables
句法 - Syntax
哈希和映射 - Hashes and maps
容器 - Containers
异常 - Exceptions
引文构造 - Quoting constructs
性能 - Performance
指令 - Pragmas
换行处理 - Newline handling in Raku
控制流 - Control Flow
数值 - Numerics
数据结构 - Data Structures
日期与时间函数 - Date and time functions
枚举 - Enumeration
正则 - Regexes
特性
相位器
类型系统
系统交互
语句前缀
语法
运算符
集合、背包和混合
输入输出权威指南 - IO the definitive guide
换行处理 - Newline handling in Raku
面向对象编程 - Object orientation.md
创建运算符 - Creating operators.md
命令行接口 - Command line interface.md
并发 - Concurrency.md
核心模组 - Core modules.md
模组 - Modules.md
模组包 - Module packages.md
模组开发工具 - Module development utilities.md
正则最佳实践与陷阱 - Regexes best practices and gotchas.md
算术 - Doing math with Raku.md
类和对象 - Classes and Objects.md
计算单元以及怎样找到他们 - CompUnits and where to find them.md
语法教程 - Grammar tutorial.md
输入 unicode 字符 - Entering unicode characters.md
输入输出 - IO.md
进程间通信 - Inter-process communication.md
迭代 - Iterating.md
